{
  "0": {
    "1": "`",
    "5": "1",
    "6": "q",
    "9": "2",
    "10": "w",
    "11": "a",
    "13": "3",
    "14": "e",
    "15": "s",
    "16": "z",
    "17": "4",
    "18": "r",
    "19": "d",
    "20": "x",
    "21": "5",
    "22": "t",
    "23": "f",
    "24": "c",
    "25": "6",
    "26": "y",
    "27": "g",
    "28": "v",
    "29": "7",
    "30": "u",
    "31": "h",
    "32": "b",
    "33": "8",
    "34": "i",
    "35": "j",
    "36": "n",
    "37": "9",
    "38": "o",
    "39": "k",
    "40": "m",
    "41": "0",
    "42": "p",
    "43": "l",
    "44": ",",
    "45": "-",
    "46": "[",
    "47": ";",
    "48": ".",
    "49": "=",
    "50": "]",
    "51": "'",
    "52": "/",
    "54": "\\"
  },
  "4": {
    "11": "á",
    "14": "é",
    "15": "š",
    "16": "ž",
    "18": "ř",
    "19": "ď",
    "22": "ť",
    "24": "č",
    "26": "ý",
    "30": "ú",
    "34": "í",
    "36": "ň",
    "38": "ó",
    "43": "ľ"
  },
  "7": {
    "1": "~",
    "5": "!",
    "6": "Q",
    "9": "@",
    "10": "W",
    "11": "A",
    "13": "#",
    "14": "E",
    "15": "S",
    "16": "Z",
    "17": "$",
    "18": "R",
    "19": "D",
    "20": "X",
    "21": "%",
    "22": "T",
    "23": "F",
    "24": "C",
    "25": "^",
    "26": "Y",
    "27": "G",
    "28": "V",
    "29": "&",
    "30": "U",
    "31": "H",
    "32": "B",
    "33": "*",
    "34": "I",
    "35": "J",
    "36": "N",
    "37": "(",
    "38": "O",
    "39": "K",
    "40": "M",
    "41": ")",
    "42": "P",
    "43": "L",
    "44": "<",
    "45": "_",
    "46": "{",
    "47": ":",
    "48": ">",
    "49": "+",
    "50": "}",
    "51": "\"",
    "52": "?",
    "54": "|"
  },
  "8": {
    "11": "ä",
    "14": "ě",
    "18": "ŕ",
    "30": "ů",
    "38": "ô",
    "43": "ĺ"
  },
  "12": {
    "14": "€"
  },
  "4+7": {
    "11": "Á",
    "14": "É",
    "15": "Š",
    "16": "Ž",
    "18": "Ř",
    "19": "Ď",
    "22": "Ť",
    "24": "Č",
    "26": "Ý",
    "30": "Ú",
    "34": "Í",
    "36": "Ň",
    "38": "Ó",
    "43": "Ľ"
  },
  "7+8": {
    "11": "Ä",
    "14": "Ě",
    "18": "Ŕ",
    "30": "Ů",
    "38": "Ô",
    "43": "Ĺ"
  }
}