{
  "0": {
    "1": "ё",
    "5": "1",
    "6": "й",
    "9": "2",
    "10": "ц",
    "11": "ф",
    "13": "3",
    "14": "у",
    "15": "ы",
    "16": "я",
    "17": "4",
    "18": "к",
    "19": "в",
    "20": "ч",
    "21": "5",
    "22": "е",
    "23": "а",
    "24": "с",
    "25": "6",
    "26": "н",
    "27": "п",
    "28": "м",
    "29": "7",
    "30": "г",
    "31": "р",
    "32": "и",
    "33": "8",
    "34": "ш",
    "35": "о",
    "36": "т",
    "37": "9",
    "38": "щ",
    "39": "л",
    "40": "ь",
    "41": "0",
    "42": "з",
    "43": "д",
    "44": "б",
    "45": "-",
    "46": "х",
    "47": "ж",
    "48": "ю",
    "49": "=",
    "50": "ъ",
    "51": "э",
    "52": ".",
    "54": "\\"
  },
  "7": {
    "1": "Ё",
    "5": "!",
    "6": "Й",
    "9": "\"",
    "10": "Ц",
    "11": "Ф",
    "13": "№",
    "14": "У",
    "15": "Ы",
    "16": "Я",
    "17": ";",
    "18": "К",
    "19": "В",
    "20": "Ч",
    "21": "%",
    "22": "Е",
    "23": "А",
    "24": "С",
    "25": ":",
    "26": "Н",
    "27": "П",
    "28": "М",
    "29": "?",
    "30": "Г",
    "31": "Р",
    "32": "И",
    "33": "*",
    "34": "Ш",
    "35": "О",
    "36": "Т",
    "37": "(",
    "38": "Щ",
    "39": "Л",
    "40": "Ь",
    "41": ")",
    "42": "З",
    "43": "Д",
    "44": "Б",
    "45": "_",
    "46": "Х",
    "47": "Ж",
    "48": "Ю",
    "49": "+",
    "50": "Ъ",
    "51": "Э",
    "52": ",",
    "54": "/"
  }
}